....#.....
...#......
.........#
..........
#.....#...
..........
...#.#....
......#...
.....##...
..........
