....#.....
.......#..
...#......
..........
..........
#.#.....#.
..#....#..
..........
..........
...##.....
