........#.
..........
..#..##...
......#.#.
...##..#..
.......##.
.....##...
........#.
..........
...#......
