..........
..#....#..
..........
..........
.......#..
.###......
.........#
#...#.#...
...##.....
.#......##
