........#.
.##...#...
#...#..##.
..........
#.........
.....#....
.......#..
.#..#.....
..#.....#.
..........
