#.........
..........
....#..#..
..........
.#........
###.......
#.#....#..
#.........
.#......##
.....#....
