#.....##..
#.#.......
#.........
..#.....#.
.#........
.....#....
...#.....#
##........
......#...
..........
