.....#..#.
...#......
#.........
.......#..
#.#..#....
....#.#...
..##......
.#......#.
..........
.....#....
