...##.....
..........
........#.
.....#.#..
....#.#.#.
........#.
........#.
..#..#.#..
#.........
......#...
