...##..#..
.......#..
..........
.#.#....#.
....#..#.#
..........
.....#..#.
..........
......#.##
..........
