........#.
..#.#.....
.....#....
.......##.
..........
..#.......
..........
....#..#..
........#.
####.....#
