.......#..
..........
.##.......
...#.....#
....#.....
......##..
..........
.#.#......
..........
..........
