...#.#....
..........
.......#..
#........#
..........
#.#.......
.....##...
......#...
....#..##.
#......#..
