..........
.......#..
..#...##..
.#......##
.##.......
..#.......
.....#..#.
.#.......#
#....#...#
##..#.....
