........#.
.....##...
....#..##.
..#.#.....
#....#...#
..........
...#..#.#.
.......##.
.......###
....#.....
