........##
#.#.......
....###...
........##
..#.##....
.##..#.#..
#..#......
..........
..#.......
.#........
