##........
....##....
....#.#..#
......####
.........#
#....##...
.......##.
....#.....
.#........
..#.......
