....#.....
##.#.....#
#.........
.#.#......
..........
#.........
...#.##..#
....###.#.
......#...
..##......
