.#..##.###
.....#.#..
.......#..
#......##.
....#.....
#.........
..........
##...#....
.........#
.#....#...
