#...#..#..
.....#....
...##...#.
.#...##..#
##..#....#
#.#.......
..........
......#...
..........
.....#..#.
