..##....##
.#........
..#...#...
......#...
........#.
.#...##...
#....#.#..
...#...#..
.#........
.#......#.
