##.......#
#.......#.
.....#..#.
..........
.#..##....
..........
##...##..#
.#.#.....#
....#.....
.#........
