#..#......
.#....#...
.......##.
..........
..........
..........
.........#
.#..#.....
..........
.........#
