#.......#.
.#.#......
..........
.#...#.#..
#...#..#..
.....#...#
.....#....
#.........
...#....#.
.#...#.##.
