..........
.......#..
..........
..#.......
....##....
..........
..........
.#........
.......##.
....#.##..
