..........
..........
#.........
.....##...
..........
..........
...#......
.........#
##...##...
.......#..
