..........
.......#..
..........
..........
........#.
..........
......#..#
....#.....
...##.....
#.......##
