......#...
###.......
.....#....
..........
..........
..#.......
..........
.......#..
.#........
...#.....#
