..........
...#......
...#......
..........
.#....#...
..........
.#........
......#...
..........
.#..#..#.#
