......#...
..........
.......#..
..##.#.#..
.......#..
..........
..........
....#.....
.#........
.......#..
